+-+-+-+-+-+-+-+-+
| |       |     |
+ + + +-+ +-+ + +
|   |   |   | | |
+   + + +-+ + + +
|   | | | |   | |
+-+-+-+ + +-+ + +
|       |   | | |
+ + +-+ +-+ + +-+
| |   |     | | |
+ +-+ +-+-+ + + +
|   | |   |   | |
+ + + + + +-+-+ +
| |     |     | |
+ + +-+ +-+ +-+ +
|       |       |
+-+ +-+ +-+-+-+-+
| | |S          |
+-+ +-+-+-+-+-+ +
|               |
+-+-+-+-+-+-+-+-+
